11111111111
10000X000C1
10000000001
1P000E00001
1000XX00001
1000000X001
11111111111
