1111111111111
10P10C0000001
1000011111001
100011E000001
1111111111111
