1111111111111111
1E00000000000001
1001111111111101
1000000C00000001
1111111111111101
1000000C00000001
1001111111111101
10000000000000P1
1111111111111111