11111111
1PCE1111
11111111
1XXXXXX1
11111111
