11111111111
10000P00001
1000CCC0001
10011111001
1X0C0000X01
100C0000X01
10011111001
1000000C001
10X0000C001
10011111001
10000C00001
10000C000E1
11111111111