11111111111111111111111
1X00011E11000CX11111111
100000000000000100000C1
110X00001110000111000C1
110000000000X00000000C1
10000111100000000111111
1X00011C1000000000C1111
1C0000000000000000000P1
11111111111111111111111