1111111111111111111111111111
10000000000000E0000000000001
10000000000X00000X0000000001
10000000000X00000X0000000001
1000X000000X00C00X00000X0001
100XCX00000X00100X0000XCX001
1000100000000111000000010001
10011100000001P1000000111001
1001110000000101000000111001
1000000000000101000000000001
1000000000000000000000000001
1111111111111111111111111111