11111111111111111111111111111
10000000000000000000000000001
10001111100000000000111110001
10001CCC1000000000001CCC10001
10001CCC1000000000001CCC10001
1000X00X000000000000X000X0001
1000X00X000000000000X000X0001
10001CCC1000000000001CCC10001
10001CCC1000000000001CCC10001
10001111100000000000111110001
1000000000000PE00000000000001
11111111111111111111111111111