11111111111
1000E0CX001
1000P00C001
10011111001
1X0CX0X001
1000C000001
10011111001
100C0000001
1000C000X01
11111111111